OOOOOOOOOOOOOOOOOOOO
Oc           OOc   O
O                  O
O      OOOO     c  O
O        OOOOOOO0 OO
OOOO     0H       0O
O        OOOOOOOOOOO
O   c    OE       cO
O        O    O    O
O   OO     OOOO    O
O        OOP0      O
O       OOSE      cO
O   c  OOOOOOOOOOOOO
O            OO0cOOO
O                  O
O        c         O
O   OOOO0          O
O             OO   O
O     0c0      cE  O
OOOOOOOOOOOOOOOOOOOO