OOOOOOOOOOOOOOOOOOOO
O                  O
O                  O
O             E    O
O  E             H O
O                  O
O000000000         O
OS                 O
O                  O
O           E  0000O
O      E           O
O                  O
O                  O
O       EEE        O
O       EBE   E    O
O  E    EEE        O
O           00000  O
O           E      O
O  H               O
OOOOOOOOOOOOOOOOOOOO