OOOOOOOOOOOOOOOOOOOO
Oc               c O
O00P               O
Oc  E              O
O      c           O
OOOOOOOOOO         O
Oc                 O
O                  O
O        c         O
Oc  OOOOOOOOOOO    O
O                  O
O                  O
O              0H0cO
O      OOOOOOOOOOOOO
O           Ec     O
O                  O
O                  O
O                  O
OcS           c    O
OOOOOOOOOOOOOOOOOOOO