OOOOOOOOOOOOOOOOOOOO
O    c            cO
O            E     O
O                  O
O  c     O         O
O        O000P     O
O        O         O
O        Oc0       O
O    OOOOOOOOO   0 O
O  E     O       0 O
O    c   O       0 O
O        O  c    0 O
O      c0O       0 O
O        O       0 O
O00000 0         0 O
O  E   0         0EO
O 000000         0 O
O 0        c     0HO
Oc0      0      S0cO
OOOOOOOOOOOOOOOOOOOO