OOOOOOOOOOOOOOOOOOOO
O            Oc0SEHO
O       0P      0 0O
O      OOOO        O
O                  O
OOOOc              O
O        OOOOOO    O
O    E             O
Oc                 O
O00cOO    OO0OO    O
O             c    O
O      O           O
O                 cO
O            OOc0OOO
O                 cO
O             E    O
O   OOOO           O
O             OO   O
Oc    0cO          O
OOOOOOOOOOOOOOOOOOOO